My&Points	我的點數	我的积分	คะแนนของฉัน	Mis&puntos	Mis&puntos	Mes&points	Mes&points	Meine&Punkte	Мои&очки	Moje&body	Punti&personali	نقاطي	Os&meus&pontos	Puanlarım	Điểm&của&Tôi	Poin&Saya	Mata&Ganjaran&Saya	मेरे&प्‍वाइंट	Mine&point	Moje&body	Moje&punkty	Saját&pontok	Pisteeni	Mijn&punten	Mina&Poäng	Moji&bodovi	Punctele&mele	Moje&točke	Οι&πόντοι&μου	הנקודות&שלי	Моите&точки	Мої&бали	Meus&pontos	Els&meus&punts	نکات&من	Moji&bodovi	내&포인트	マイ・ポイント	Mine&poeng	Мои&поенти	Os&meus&puntos	Nire&puntuak	Pikët&e&mia	আমার&পয়েন্ট	ពិន្ទុរបស់ខ្ញុំ	ကြ်ႏ္ုပ္၏&ရမွတ္မ်ား	Mani&punkti	Mano&taškai	Minu&punktid	ຄະແນນຂອງ​ຂ້ອຍ	میرے&پوائنٹس
Total	總共	总的	ทั้งหมด	Total	Total	Total	Total	Insgesamt	Всего	Celkom	Totale	الإجمالي	Total	Toplam	Tổng&cộng	Total	Jumlah	कुल	I&alt	Celkem	Razem	Összesen	Yhteensä	Totaal	Totalt	Ukupno	Total	Skupno	Σύνολο	סך&הכל	Общо	Усього	Total	Total	کلی	Ukupno	총	合計	Totalt	Вкупно	Total	Guztira	Gjithsej	মোট	សរុប	စုစုေပါင္း	Kopā	Iš&viso	Kokku	ທັງໝົດ	کُل
points	點數	分/积分	คะแนน	puntos	puntos	points	points	Punkte	очки	body	punti	النقاط	pontos	puan	điểm	poin	mata&ganjaran	प्‍वाइंट	Point	body/bodů	punktów	pont	pistettä	punten	poäng	bodovi	puncte	točk	πόντοι	סה"כ	точки	бали	pontos	punts	نکات	bodovi	포인트	ポイント	poeng	поента	puntos	puntu	pikët	পয়েন্ট	ពិន្ទុ	ရမွတ္မ်ား	punkti	taškų	punktid	ຄະແນນ	پوائنٹس
Exchange	交換	兑换	แลกเปลี่ยน	Intercambio	Intercambio	Échanger	Échange	Tauschen	Обмен	Výmena	Scambia	التبادل	Troca	Takas	Trao&đổi	Tukar	Pertukaran	विनिमय	Veksling	Výměna	Wymiana	Váltás	Vaihto	Omwisselen	Byt	Razmjena	Schimbare	Izmenjava	Ανταλλαγή	המרה	Обмяна	Обмін	Trocar	Bescanvi	مبادله	Razmena	교환	交換	Veksle	Размена	Troco	Trukatu	Shkëmbim	এক্সচেঞ্জ	ផ្លាស់ប្តូរ	ဖလွယ္မႈ	Maiņa	Keisti	Vaheta	​ແລກ​ປ່ຽນ	ایکسچینج
Exchange&record	交換記錄	兑换记录	บันทึกการแลกเปลี่ยน	Registro&de&intercambios	Registro&de&intercambios	Registre&d’échange	Dossier&d’échange	Tauschverlauf	Запись&об&обмене	Záznam&výmeny	Scambia&record	سجل&التبادل	Registo&de&troca	Takas&kaydı	Bản&ghi&trao&đổi	Riwayat&Penukaran	Rekod&pertukaran	विनिमय&रिकॉर्ड	Vekslingsoversigt	Záznam&výměny	Rejestr&wymian	Váltásra&vonatkozó&adatok	Vaihtohistoria	Omwisselingsrecord	Byteshistorik	Zapis&razmjene	Date&privind&schimbarea	Zapis&izmenjave	Αρχείο&ανταλλαγής	היסטוריית&המרות	Запис&на&обмяна	Запис&обміну	Registro&de&trocas	Registre&de&bescanvis	گزارش&مبادله	Evidencija&razmene	교환&기록	交換履歴	Vekslelogg	Размени&снимено	Rexistro&de&trocos	Trukeen&erregistroa	të&dhënat&e&shkëmbimit	এক্সচেঞ্জ&রেকর্ড	ផ្លាស់ប្តូរកំណត់ត្រា	ဖလွယ္မွတ္တမ္း	Maiņas&ieraksts	Keisti&įrašą	Vahetuste&ajalugu	ບັນ​ທຶກການ​ແລກ​ປ່ຽນ	ایکسچینج&ریکارڈ
Details&of&one&month&recently	最近一月的詳細信息	最近一个月的明细	รายละเอียดของเดือนล่าสุด	Detalles&del&último&mes	Detalles&del&último&mes	Détails&d’un&mois&récent	Détails&d’un&mois&récent	Details&zum&vergangenen&Monat	Подробная&информация&за&недавний&один&месяц	Podrobnosti&posledného&mesiaca	Dettagli&ultimo&mese	تفاصيل&شهر&واحد&مؤخرًا	Detalhes&de&um&mês&recentemente	Son&bir&ay&ayrıntıları	Chi&tiết&một&tháng&gần&đây	Rincian&satu&bulan&terakhir	Butiran&sebulan&yang&terbaharu	हाल&के&एक&माह&के&ब्‍यौरे	Detaljer&for&en&måned&for&nylig	Podrobnosti&za&poslední&měsíc	Szczegółowe&dane&z ostatniego&miesiąca	Adatok&egy&hónapra&visszamenőleg	Viimeisen&kuukauden&tiedot	Details&van&afgelopen&maand	Senaste&månadens&detaljer	Detalji&proteklog&mjeseca	Detalii&privind&luna&recentă	Nedavne&podrobonosti&enega&meseca	Πρόσφατες&λεπτομέρειες&ενός&μήνα	פעולות&בחודש&האחרון	Подробности&за&един&месец&назад	Інформація&за&останній&місяць	Detalhes&de&um&mês&recentemente	Dades&de&l'últim&mes	جزئیات&یک&ماه&اخیر	Detalji&za&jedan&mesec&unazad	최근&1개월&세부&정보	最近1ヵ月の詳細	Nylige&detaljer&for&en&måned	Детали&од&еден&месец	Detalles&do&último&mes	Azken&hilabeteko&xehetasunak	Detajet&e&një&muaji&të&fundit	সম্প্রতি&এক&মাসের&বিশদ&বিবরণ	ព័ត៌មានលម្អិតនៃមួយខែថ្មីៗនេះ	လတ္တေလာ&တစ္လတာအတြက္&အေသးစိတ္မ်ား	Ziņas&par&pēdējo&mēnesi	Informacija&apie&vieną&mėnesį&(naujausią)	Andmed&viimase&kuu&kohta	ລາຍ​ລະ​ອຽດ​ຂອງ​ໜຶ່ງ​ເດືອນ​ບໍ່​ດົນ​ມາ​ນີ້	حال&کے&ایک&مہینہ&کی&تفصیلات
Loading	正在加載	加载中	กำลังโหลด	Cargando	Cargando	Chargement	Chargement	Wird&geladen	Загрузка...	Načítava&sa	Caricamento&in&corso	تحميل	A&carregar	Yükleniyor	Đang&tải	Memuat	Memuatkan	लोड&हो&रहा&है	Loader	Načítání	Wczytywanie	Betöltés	Ladataan	Laden	Läser&in	Učitavanje	Se&încarcă	Nalaganje	Φόρτωση	‏טוען	Зареждане	Завантаження	Carregando	S'està&carregant…	بارگیری	Učitavanje	로딩&중	読み込み中	Laster&inn	Вчитување	Cargando	Kargatzen	Duke&u&ngarkuar	লো্ড&হচ্ছে	កំពុងដំណើរការ	ဖြင့္ေနသည္	Notiek&ielāde	Įkeliama	Laadimine	ກຳ​ລັງ​ໂຫຼດ	لوڈ&کر&رہا&ہے
No&more&data&is&available&at&the&moment.	此時無更多內容可用。	暂时没有更多的数据	ไม่มีข้อมูลเพิ่มเติมให้ในขณะนี้	No&hay&más&datos&disponibles&en&este&momento.	No&hay&más&datos&disponibles&en&este&momento.	Plus&aucune&donnée&n’est&disponible&pour&le&moment.	Aucune&autre&donnée&disponible&pour&le&moment.	Derzeit&sind&keine&weiteren&Daten&verfügbar.	Нет&больше&доступных&данных&на&данный&момент.	V&tejto&chvíli&nie&sú&dostupné&žiadne&ďalšie&dáta.	Nessun&altro&dato&disponibile&al&momento.	لا&تتوفر&المزيد&من&البيانات&في&الوقت&الحالي.	Sem&mais&dados&disponíveis&de&momento.	Şu&anda&daha&fazla&veri&yok.	Không&có&thêm&dữ&liệu&nào&vào&thời&điểm&này.	Belum&ada&data&untuk&saat&ini.	Tiada&data&lagi&tersedia&pada&ketika&ini.	इस&समय&और&डेटा&उपलब्‍ध&नहीं&है.	Der&er&ikke&mere&data&tilgængeligt&i&øjeblikket.	Momentálně&nejsou&k dispozici&žádná&další&data.	Aktualnie&brak&dalszych&danych.	Jelenleg&nem&állnak&rendelkezésre&további&adatok.	Ei&enempää&tietoja&tällä&hetkellä.	Er&zijn&momenteel&niet&meer&gegevens&beschikbaar.	Ingen&mer&information&är&tillgänglig&för&tillfället.	Trenutno&nema&više&dostupnih&podataka.	Nu&există&alte&date&disponibile&în&prezent.	Trenutno&na&voljo&ni&več&podatkov.	Δεν&υπάρχουν&άλλα&διαθέσιμα&δεδομένα&αυτήν&τη&στιγμή.	אין&כרגע&נתונים&נוספים	Няма&още&налични&данни&в&момента.	На&даний&час&немає&доступних&даних.	Não&há&mais&dados&disponíveis&no&momento.	En&aquest&moment&no&hi&ha&més&dades&disponibles.	در&حال&حاضر&داده&دیگری&موجود&نیست.	U&ovom&trentutku&nema&više&dostupnih&podataka.	지금&더&이상의&데이터를&사용할&수&없습니다.	現在、他にデータはありません。	Ingen&flere&data&er&for&øyeblikket&tilgjengelige.	Нема&достапни&податоци&во&моментот.	Non&hai&máis&datos&dispoñibles&nestes&momentos.	Ez&dago&beste&daturik.	Nuk&ka&më&shumë&të&dhëna&të&disponueshme&në&këtë&moment.	এখন&আর&কোনো&ডেটা&উপলব্ধ&নেই।	គ្មានទិន្នន័យច្រើនទៀតអាចរកបាននៅខណៈនេះឡើយ។	လက္ရွိအခ်ိန္တြင္&ေနာက္ထပ္&မည္သည့္ေဒတာကုိမွ&မရႏုိင္ေတာ့ပါ။	Pašlaik&vairāk&datu&nav.	Šiuo&metu&daugiau&duomenų&nėra.	Rohkem&andmeid&praegu&ei&ole.	ບໍ່​ມີ​ຂໍ້​ມູນ​ເພີ່ມ​ເຕີມ​ໃຫ້​ຢູ່​ໃນ​ເວ​ລາ​ນີ້.	اس&وقت&مزید&کوئی&ڈیٹا&دستیاب&نہیں&ہے۔
No&results	找不到任何結果	没有数据	ไม่มีผลลัพธ์	Ningún&resultado	Sin&resultados	Aucun&résultat	Aucun&résultat	Keine&Ergebnisse	Нет&результатов	Žiadne&výsledky	Nessun&risultato	لا&توجد&نتائج	Sem&resultados	Sonuç&yok	Không&có&kết&quả	Tidak&ada&hasil	Tiada&hasil	कोई&परिणाम&नहीं	Ingen&resultater	Žádné&výsledky	Brak&wyników	Nincsenek&eredmények	Ei&tuloksia	Geen&resultaten	Inga&resultat	Nema&rezultata	Niciun&există&rezultate	Ni&rezultatov	Κανένα&αποτέλεσμα	אין&תוצאות	Няма&резултати	Немає&результатів	Nenhum&resultado	No&hi&ha&cap&resultat.	نتیجه&ای&وجود&ندارد	Nema&rezultata	결과&없음	なし	Ingen&treff	Нема&резултати.	Ningún&resultado	Ez&dago&emaitzarik	Nuk&ka&rezultate	কোন&ফলাফল&নেই	គ្មាន​លទ្ធផល	ရလဒ္မ်ား&မရွိပါ	Nav&rezultātu	Rezultatų&nėra	Tulemusi&pole	ບໍ່ມີຜົນໄດ້ຮັບ	کوئی&نتائج&نہیں
"We&are&unable&to&get&the&data&from&the&server&at&the&moment.
Please&click&on&the&button&to&try&again"	"此時我們無法從伺服器上獲取資料。
請點選圖標再次嘗試。"	我们暂时不能从服务器端获取到数据。请点击按钮重试。	"เราไม่สามารถรับข้อมูลจากเซิร์ฟเวอร์ได้ในขณะนี้
โปรดคลิกที่ปุ่มเพื่อลองอีกครั้ง"	"No&podemos&descargar&los&datos&del&servidor&en&este&momento.
Haga&clic&en&el&botón&para&volver&a&intentarlo."	"No&podemos&descargar&los&datos&del&servidor&en&este&momento.
Haga&clic&en&el&botón&para&volver&a&intentarlo."	"Il&nous&est&impossible&de&récupérer&les&données&du&serveur&pour&le&moment.
Cliquez&sur&le&bouton&pour&réessayer."	"Nous&ne&pouvons&obtenir&de&données&du&serveur&pour&le&moment.
Cliquez&sur&le&bouton&pour&réessayer."	"Wir&können&die&Daten&derzeit&nicht&vom&Server&abrufen.
Klicken&Sie&auf&das&Schaltfläche,&um&es&erneut&zu&versuchen."	"Невозможно&получить&данные&с&сервера&в&данный&момент.
Нажмите&на&кнопку,&чтобы&попробовать&еще&раз"	"Momentálne&nebolo&možné&získať&dáta&zo&servera.
Ak&to&chcete&skúsiť&znova,&kliknite&na&tlačidlo."	"Impossibile&recuperare&i&dati&dal&server&al&momento.
Fare&clic&sul&tasto&per&riprovare"	"يتعذر&علينا&الحصول&على&البيانات&من&الخادم&في&الوقت&الحالي.
يرجى&النقر&فوق&الزر&للمحاولة&مرة&أخرى"	"Não&é&possível&obter&os&dados&do&servidor&de&momento.
Clique&no&botão&para&tentar&novamente"	"Şu&anda&verileri&sunucudan&alamıyoruz.
Tekrar&denemek&için&düğmeye&tıklayın"	"Chúng&tôi&không&thể&nhận&được&dữ&liệu&từ&máy&chủ&vào&lúc&này.
Vui&lòng&nhấp&vào&nút&đó&để&thử&lại"	"Kami&tidak&dapat&mengambil&data&dari&server&saat&ini.
Klik&tombol&untuk&mencoba&lagi."	"Kami&tidak&berjaya&mendapatkan&data&daripada&pelayan&pada&ketika&ini.
Sila&klik&pada&butang&untuk&mencuba&lagi"	"हम&इस&समय&सर्वर&से&डेटा&प्राप्‍त&करने&में&असमर्थ&हैं.
कृपया&पुन:प्रयास&करने&के&लिए&बटन&पर&क्लिक&करें"	"Vi&kan&ikke&få&data&fra&serveren&i&øjeblikket.
Tryk&venligst&på&knappen&for&at&prøve&igen."	"Momentálně&nelze&získat&data&ze&serveru.
Klikněte&na&tlačítko&a zkuste&to&znovu"	"Aktualnie&pobranie&danych&z serwera&nie&jest&możliwe.
Kliknij&przycisk,&aby&spróbować&ponownie"	"Az&adatok&letöltése&a&szerverről&jelenleg&nem&lehetséges.
Kattintson&a&gombra&az&újrapróbáláshoz."	"Tietojen&haku&palvelimesta&epäonnistui.
Napsauta&painiketta&ja&yritä&uudelleen"	"De&gegevens&kunnen&momenteel&niet&worden&opgehaald&van&de&server.
Klik&op&de&knop&om&het&opnieuw&te&proberen"	"Vi&kunde&inte&hämta&informationen&från&servern&just&nu.
Tryck&på&knappen&och&försök&igen"	"Trenutno&nismo&u&mogućnosti&dohvatiti&aplikacije&s&poslužitelja.
Molimo,&kliknite&na&tipku&za&ponovni&pokušaj"	"Nu&puteți&obține&datele&de&pe&server&în&acest&moment.
Dați&clic&pe&buton&pentru&a&încerca&din&nou"	"Pridobitev&podatkov&s&strežnika&trenutno&ni&mogoča.
Za&ponoven&poskus&kliknite&na&tipko."	"Δεν&είναι&δυνατή&η&λήψη&των&δεδομένων&από&το&διακομιστή&αυτήν&τη&στιγμή.
Κάντε&κλικ&στο&κουμπί&για&να&δοκιμάσετε&ξανά"	"כרגע&אין&אפשרות&לקבל&את&הנתונים&מהשרת.
לחץ&על&הלחצן&כדי&לנסות&שוב."	"Не&сме&в&състояние&да&получим&данните&от&сървъра&в&момента.
Моля,&щракнете&върху&иконата&за&повторен&опит."	"На&даний&час&неможливо&отримати&дані&з&сервера.
Натисніть&кнопку&для&повторної&спроби"	"Não&conseguimos&os&dados&do&servidor&no&momento.
Clique&no&botão&para&tentar&novamente"	"En&aquest&moment&no&podem&obtenir&les&dades&del&servidor.
Feu&clic&al&botó&per&tornar-ho&a&provar."	"نمی&توانیم&در&حال&حاضر&داده&ها&را&از&سرور&دریافت&کنیم.
لطفاً&برای&امتحان&دوباره&روی&دکمه&کلیک&کنید."	"U&ovom&trenutku&ne&možemo&da&preuzmemo&podatke&sa&servera.
Kliknite&na&taster&da&biste&pokušali&ponovo."	"현재&서버에서&데이터를&불러올&수&없습니다.
버튼을&클릭하고&다시&시도하십시오."	"現在、サーバーからデータを取得できません。
ボタンをクリックして再試行してください。"	"Vi&kunne&ikke&hente&data&fra&serveren&nå.
Klikk&på&knappen&og&prøv&igjen."	Не&сме&во&можност&да&добиеме&податоци&од&серверот&во&моментот.&Притиснете&го&копчето&и&обидете&се&повторно.	"Nestes&momentos&non&podemos&obter&os&datos&do&servidor.
Faga&clic&no&botón&para&tentalo&de&novo."	"Ezin&izan&ditugu&eskuratu&datuak&zerbitzaritik.
Sakatu&botoia&berriro&saiatzeko"	"Ne&nuk&jemi&në&gjendje&për&të&marrë&të&dhënat&nga&serveri&në&këtë&moment.
Ju&lutem&klikoni&në&butonin&për&të&provuar&përsëri"	"এখন&আমরা&সার্ভার&থেকে&ডেটা&আনতে&পাচ্ছি&না।
আবার&চেষ্টা&করতে&অনুগ্রহ&করে&নিচের&বোতামে&ক্লিক&করুন"	"យើងមិនអាចទទួលបានទិន្នន័យពីម៉ាស៊ីនមេនៅខណៈនេះឡើយ។
សូមចុចលើប៊ូតុងដើម្បីព្យាយាមម្តងទៀត។"	"လက္ရွိအခ်ိန္တြင္&ဆာဗာထံမွ&ေဒတာမ်ား&ရယူႏုိင္ျခင္း&မရွိေသးပါ။
ထပ္ႀကိဳးစားရန္&ခလုတ္ေပၚကုိ&ႏွိပ္ပါ"	"Šobrīd&neizdevās&iegūt&datus&no&servera.
Lūdzu,&noklikšķiniet&uz&pogas&un&mēģiniet&vēlreiz"	"Šiuo&metu&nepavyko&gauti&duomenų&iš&serverio.
Spustelėkite&mygtuką,&jei&norite&pabandyti&dar&kartą"	"Andmete&hankimine&serverist&ebaõnnestus&praegu.
Uuesti&proovimiseks&klõpsa&nupule."	"ພວກ​ເຮົາ​ບໍ່​ສາ​ມາດ​ເອົາ​ຂໍ້​ມູນ​ຈາກ​ເຊີບ​ເວີ​ໄດ້​ໃນ​ຂະ​ນະ​ນີ້.
ກະ​ລຸ​ນາ​ຄ​ລິກ​ໃສ່​ເທິງ​ປຸ່ມ&ເພື່ອ​ລອງ​ໃໝ່​ອີກ"	"اس&وقت&ہم&سرور&سے&ڈیٹا&حاصل&کرنے&سے&قاصر&ہیں۔
براہ&کرم&دوبارہ&کوشش&کرنے&کے&لئے&بٹن&پر&کلک&کریں۔"
Network&connection&is&failed.&Please&check&your&network&and&try&again.	網路連線失敗。請檢查您的網路連線并再次嘗試。	网络连接失败。请查看你的网络并重试。	การเชื่อมต่อเครือข่ายล้มเหลว&โปรดตรวจสอบเครือข่ายของคุณและลองอีกครั้ง	No&se&ha&podido&establecer&una&conexión&de&red.&Compruebe&su&red&e&inténtelo&de&nuevo.	No&se&pudo&establecer&una&conexión&de&red.&Compruebe&su&red&e&inténtelo&de&nuevo.	Échec&de&la&connexion&réseau.&Vérifiez&votre&connexion&réseau,&puis&réessayez.	Échec&de&connexion&réseau.&Veuillez&vérifier&votre&réseau&et&réessayer.	Netzwerkverbindung&fehlgeschlagen.&Überprüfen&Sie&Ihr&Netzwerk&und&versuchen&Sie&es&erneut.	Не&удалось&подключиться&к&сети.&Пожалуйста,&проверьте&вашу&сеть&и&попробуйте&еще&раз.	Sieťové&pripojenie&zlyhalo.&Skontrolujte&svoju&sieť&a&skúste&to&znova.	Connessione&di&rete&non&riuscita.&Controllare&la&connessione&di&rete&e&riprovare.	فشل&الاتصال&بالشبكة.&يُرجى&التحقق&من&الشبكة&والمحاولة&مرة&أخرى.	Ligação&à&rede&falhou.&Verifique&a&rede&e&tente&novamente.	Ağ&bağlantısı&başarısız.&Lütfen&ağınızı&kontrol&edip&tekrar&deneyin.	Không&kết&nối&được&mạng.&Vui&lòng&kiểm&tra&mạng&của&bạn&và&thử&lại.	Koneksi&jaringan&gagal.&Periksa&pengaturan&jaringan&lalu&cobalah&lagi.	Sambungan&rangkaian&gagal.&Sila&periksa&rangkaian&anda&dan&cuba&lagi.	नेटवर्क&कनेक्शन&विफल&है.&कृपया&अपना&नेटवर्क&जांचें&और&फिर&से&कोशिश&करें.	Netværksforbindelsen&er&fejlet.&Tjek&venligst&dit&netværk&og&prøv&igen.	Připojení&k síti&se&nezdařilo.&Zkontrolujte&připojení&k síti&a zkuste&to&znovu.	Nawiązywanie&połączenia&z&siecią&nie&powiodło&się.&Sprawdź&sieć&i spróbuj&ponownie.	Nem&áll&rendelkezésre&hálózati&kapcsolat.&Ellenőrizze&a&hálózatot,&majd&próbálja&újra.	Verkkoyhteys&epäonnistui.&Tarkista&verkkoyhteytesi&ja&yritä&uudelleen.	Netwerkverbinding&is&mislukt.&Controleer&uw&netwerk&en&probeer&het&opnieuw.	Nätverksanslutning&misslyckades.&Kontrollera&din&nätverksanslutning&och&försök&igen.	Mrežna&veza&nije&uspjela.&Molimo,&provjerite&mrežu&i&pokušajte&ponovno.	Conectare&la&rețea,&nereușită.&Verificați&rețeaua&și&încercați&din&nou.	Omrežna&povezava&ni&vzpostavljena.&Preverite&omrežje&in&poskusite&znova.	Η&σύνδεση&δικτύου&απέτυχε.&Ελέγξτε&το&δίκτυο&και&δοκιμάστε&ξανά.	החיבור&לרשת&נכשל.&בדוק&את&החיבור&לרשת&ונסה&שוב.	Неуспешна&връзка&с&мрежата.&Моля,&проверете&мрежата&и&опитайте&отново.	Збій&підключення&до&мережі.&Перевірте&налаштування&мережі&та&спробуйте&ще&раз.	A&conexão&de&rede&falhou.&Verifique&a&sua&rede&e&tente&novamente.	Error&en&la&connexió&de&xarxa.&Comproveu&la&xarxa&i&torneu-ho&a&provar.	اتصال&شبکه&قطع&است.&لطفاً&شبکه&خود&را&بررسی&کرده&و&دوباره&امتحان&کنید.	Povezivanje&na&mrežu&nije&uspelo.&Proverite&mrežu&i&pokušajte&ponovo.	네트워크&연결에&실패했습니다.&네트워크를&확인하고&다시&시도하십시오.	ネットワーク接続できませんでした。ネットワークを確認して再試行してください。	Nettverkstilkobling&mislyktes.&Vennligst&kontroller&nettverket,&og&prøv&igjen.	Неуспешна&мрежа.&Проверете&ја&вашата&мрежа&и&обидете&се&повторно.	Fallou&a&conexión&de&rede.&Comprobe&que&ten&Internet&e&ténteo&de&novo.	Huts&egin&du&sarerako&konexioak.&Egiaztatu&sarera&konektatuta&zaudela&eta&saiatu&berriro.	Lidhja&e&rrjetit&është&e&dështuar.&Ju&lutem&kontrolloni&rrjetit&tuaj&dhe&provoni&përsëri.	নেটওয়ার্ক&যোগাযোগ&ব্যর্থ&হয়েছে।&অনুগ্রহ&করে&আপনার&নেটওয়ার্ক&চেক&করুন&এবং&আবার&চেষ্টা&করুন।	ការតភ្ជាប់បណ្តាញបានបរាជ័យ។&សូមពិនិត្យបណ្តាញរបស់អ្នក&ហើយព្យាយាមម្តងទៀត។	ကြန္ယက္ခ်ိတ္ဆက္မႈ&မေအာင္ျမင္ပါ။&ကြန္ယက္ခ်ိတ္ဆက္မႈကုိ&စစ္ေဆးၿပီး&ထပ္ႀကိဳးစားပါ	Tīkla&savienojums&neveiksmīgs.&Lūdzu,&pārbaudiet&tīklu&un&mēģiniet&vēlreiz.	Nepavyko&prisijungti&prie&tinklo.&Patikrinkite&tinklą&ir&bandykite&dar&kartą.	Võrguühenduse&loomine&ebaõnnestus.&Kontrolli&võrku&ja&proovi&uuesti.	ການເຊື່ອມຕໍ່ເຄືອຂ່າຍບໍ່​ສຳ​ເລັດ.&ກະ​ລຸ​ນາກວດ​ເບິ່ງ​ເຄືອ​ຂ່າຍ​ຂອງ​ທ່ານ&ແລະ&​ລອງ​ໃໝ່​ອີກ.	نیٹ&ورک&کنکشن&ناکام&ہے۔&براہ&کرم&اپنے&نیٹ&ورک&کی&جانچ&کریں&اور&دوبارہ&کوشش&کریں۔
TRY&AGAIN	再次嘗試	重试	ลองอีกครั้ง	VOLVER&A&INTENTARLO	VOLVER&A&INTENTAR	RÉESSAYER	RÉESSAYER	ERNEUT&VERSUCHEN	ПОВТОРИТЬ	SKÚSTE&TO&ZNOVA	RIPROVA	إعادة&المحاولة	TENTAR&NOVAMENTE	TEKRAR&DENEYİN	THỬ&LẠI	COBA&LAGI	CUBA&LAGI	फिर&से&प्रयास&करें	PRØV&IGEN	ZKUSTE&TO&ZNOVU	SPRÓBUJ&PONOWNIE	PRÓBÁLJA&ÚJRA	YRITÄ&UUDELLEEN	PROBEER&OPNIEUW	FÖRSÖK&IGEN	POKUŠAJTE&PONOVNO	ÎNCERCAȚI&DIN&NOU	PONOVEN&POSKUS	ΔΟΚΙΜΑΣΤΕ&ΞΑΝΑ	נסה&שוב	ОПИТАЙТЕ&ОТНОВО	СПРОБУЙТЕ&ЩЕ&РАЗ	TENTAR&NOVAMENTE	TORNEU-HO&A&PROVAR.	دوباره&امتحان&کنید	POKUŠAJ&PONOVO	다시&시도하세요.	再試行してください	PRØV&IGJEN	ОБИДИ&СЕ&ПОВТОРНО	TÉNTEO&DE&NOVO	SAIATU&BERRIRO	PROVONI&PËRSËRI	আবার&চেষ্টা&করুন	ព្យាយាម​ម្តង​ទៀត	ထပ္ႀကိဳးစားပါ	MĒĢINIET&VĒLREIZ	BANDYTI&VĖL	PROOVI&UUESTI	ລອງໃໝ່ອີກ	دوبارہ&کوشش&کریں
GO	前往	进入	ไป	IR	IR	OK	ALLER	LOS	ВПЕРЁД	PREJSŤ	VAI	انطلق	IR	GİT	ĐI	GO	PERGI	जाएं	START	PŘEJÍT	IDŹ	UGRÁS	SIIRRY	GA	KÖR	IDI	ACCESAȚI	POJDI	ΜΕΤΑΒΑΣΗ	בצע	ОТИДИ	ПЕРЕЙТИ	IR	ENDAVANT	رفتن	KRENI	이동	移動	START	ОДИ	IR	JOAN	SHKO	যান	ទៅ	သြားရန္	AIZIET!	EITI	MINE	ໄປ	جائیں
Effictive&date	生效日期	有效期	วันที่มีผล	Fecha&de&vigencia	Fecha&de&vigencia	Date&d’effet	Date&d’entrée&en&vigueur	Gültigkeitsdatum	Дата&вступления&в&силу	Efektívny&dátum	Data&effettiva	تاريخ&النفاذ	Data&efetiva	Geçerli&tarih	Ngày&có&hiệu&lực	Tanggal&berlaku	Tarikh&kuat&kuasa	प्रभावी&तिथि	Effektiv&dato	Datum&platnosti	Data&obowiązywania	Hatálybalépés&dátuma	Voimaantulopäivä	Ingangsdatum	Startdatum	Datum&stupanja&na&snagu	Data&intrării&în&vigoare	Datum&veljave	Ημερομηνία&έναρξης&ισχύος	תאריך&תוקף	Дата&на&влизане&в&сила	Фактична&дата	Data&de&entrada&em&vigor	Data&efectiva	تاریخ&مؤثر	Datum&stupanja&na&snagu	효율적인&데이터	有効期限	Gyldig&fra	Датум&на&важење	Data&efectiva	Burutze-data	Data&e&hyrjes&në&fuqi	কার্যকরি&তারিখ	កាលបរិច្ឆេទប្រសិទ្ធភាព	စတင္အက်ံဳးဝင္သည့္ရက္	Spēkā&stāšanās&datums	Įsigaliojimo&data	Kehtivad&andmed	ວັນທີມີຜົນບັງຄັບໃຊ້	موثر&تاریخ
Cost	花費	花费/费用	ค่าใช้จ่าย	Coste	Costo	Coût	Coût	Kosten	Стоимость	Náklad	Costo	التكلفة	Custo	Maliyet	Chi&phí	Ongkos	Kos	लागत	Pris	Cena	Koszt	Költség	Hinta	Kosten	Kostnad	Trošak	Cost	Cena	Κόστος	עלות	Цена	Вартість	Custo	Cost	هزینه	Cena	비용	コスト	Kostnad	Цена	Custo	Kostua	Kosto	খরচ	ថ្លៃចំណាយ	ကုန္က်စရိတ္	Cena	Suma	Kulu	ມູນຄ່າ	قیمت
Detail&information	詳細資訊	详情	ข้อมูลรายละเอียด	Información&detallada	Información&detallada	Détails	Information&détaillée	Detaillierte&Informationen	Подробная&информация	Podrobné&informácie	Informazioni&dettagliate	معلومات&تفصيلية	Informações&detalhadas	Ayrıntılı&bilgi	Thông&tin&chi&tiết	Rincian&informasi	Maklumat&butiran	विस्तृत&सूचना	Detaljeret&information	Podrobné&informace	Szczegółowe&informacje	Részletes&információ	Yksityiskohtaiset&tiedot	Detailgegevens	Detaljerad&information	Detaljne&informacije	Informații&detaliate	Podrobne&informacije	Λεπτομερείς&πληροφορίες	מידע&מפורט	Подробна&информация	Подробиці	Informações&detalhadas	Informació&detallada	اطلاعات&جزئیات	Detaljne&informacije	세부&정보	詳細情報	Detaljinformasjon	Детални&информации	Información&detallada	Xehetasunak	Informacion&të&detajuar	বিস্তারিত&তথ্য	ព័ត៌មានលម្អិត	အေသးစိတ္&အခ်က္အလက္	Detalizēta&informācija	Išsami&informacija	Üksikasjalik&teave	ຂໍ້​ມູນ​ລະ​ອຽດ	تفصیلی&معلومات
Insufficient&Credit	信用不足	积分不足	เครดิตไม่เพียงพอ	Crédito&insuficiente	Crédito&insuficiente	Solde&insuffisant	Crédit&insuffisant	Nicht&genügend&Guthaben	Недостаточный&кредит	Nedostatočný&kredit	Credito&insufficiente	الرصيد&غير&كافٍ	Crédito&insuficiente	Yetersiz&Kredi	Không&đủ&Tín&dụng	Pulsa&Tidak&Cukup	Kredit&Tidak&Mencukupi	अपर्याप्त&क्रेडिट	Utilstrækkelig&midler	Nedostatečný&kredit	Brak&wystarczających&środków	Nincs&elegendő&egyenleg	Liian&vähän&varoja	Onvoldoende&tegoed	Otillräckliga&medel	Nema&dovoljno&sredstava	Credit&insuficient	Nezadosten&kredit	Ανεπαρκές&υπόλοιπο	אין&די&נקודות&זכות	Недостатъчен&кредит	Недостатньо&коштів	Crédito&insuficiente	No&hi&ha&prou&crèdit.	اعتبار&ناکافی	Nema&dovoljno&kredita	크레딧&부족	クレジットが不足しています	Manglende&kredit	Нема&доволно&кредит	Crédito&insuficiente	Ez&duzu&behar&adina&saldo	Kredi&të&pamjaftueshme	অপর্যাপ্ত&ক্রেডিট	ឥណទានមិនគ្រប់គ្រាន់	ေငြ&မလံုေလာက္ပါ	Nepietiekams&kredīts	Nepakanka&lėšų	Ebapiisav&krediit	ເງິນ​ບໍ່​ພຽງ​ພໍ	ناکافی&کریڈٹ
Please&enter&your&mobile&phone&number.	請輸入您的手機號碼。	请输入你的手机号码	โปรดใส่หมายเลขโทรศัพท์ขอคุณ	Introduzca&su&número&de&teléfono&móvil.	Ingrese&su&número&de&teléfono&móvil.	Saisissez&votre&n°&téléphone&portable.	Veuillez&entrer&votre&numéro&de&téléphone&mobile.	Geben&Sie&Ihre&Mobiltelefonnummer&ein.	Пожалуйста,&введите&номер&вашего&мобильного&телефона.	Zadajte&svoje&mobilné&telefónne&číslo.	Immettere&il&numero&di&telefono&cellulare.	يُرجى&إدخال&رقم&هاتفك&المحمول.	Introduza&o&número&do&seu&telemóvel.	Lütfen&cep&telefonu&numaranızı&girin.	Vui&lòng&nhập&số&điện&thoại&di&động&của&bạn.	Masukkan&nomor&ponsel&Anda.	Sila&masukkan&nombor&telefon&bimbit&anda.	कृपया&अपना&मोबाइल&फोन&नंबर&डालें.	Indtast&venligst&dit&mobiltelefonnummer.	Zadejte&číslo&mobilního&telefonu.	Wpisz&numer&telefonu&komórkowego.	Adja&meg&a&mobiltelefonszámát	Anna&matkapuhelinnumerosi.	Geef&uw&mobiele&telefoonnummer&op.	Ange&ditt&mobilnummer	Molimo,&unesite&broj&telefona	Introduceți&numărul&dvs.&de&mobil.	Vnesite&svojo&telefonsko&številko.	Καταχωρίστε&τον&αριθμό&του&κινητού&σας&τηλεφώνου.	נא&הזן&את&מספר&הטלפון&הנייד&שלך.	Моля,&въведете&вашия&мобилен&телефонен&номер.	Введіть&номер&мобільного&телефону.	Insira&o&seu&número&de&celular.	Introduïu&el&vostre&número&de&telèfon.	لطفاً&شماره&تلفن&همراه&خود&را&وارد&کنيد.	Unesite&svoj&broj&mobilnog&telefona.	귀하의&휴대폰&번호를&입력하십시오.	携帯電話番号を入力してください。	Skriv&inn&mobilnummeret&ditt.	Ве&молиме&внесете&го&вашиот&мобилен&број.	Introduza&o&seu&número&de&teléfono&móbil.	Idatzi&mugikorreko&telefono-zenbakia.	Ju&lutemi&shkruani&numrin&tuaj&të&telefonit&celular.	অনুগ্রহ&করে&আপনার&মোবাইল&ফোন&নম্বর&দিন।	សូមបញ្ចូលលេខទូរស័ព្ទចល័តរបស់អ្នក។	သင့္ဖုန္းနံပါတ္ကုိ&ထည့္သြင္းပါ။	Lūdzu,&ievadiet&sava&mobilā&tālruņa&numuru.	Įveskite&savo&telefono&numerį.	Sisesta&oma&mobiilinumber	ກະລຸນາໃສ່ເບີໂທລະສັບມື​ຖື​ຂອງ​ທ່ານເຂົ້າໄປ.	براہ&کرم&اپنا&موبائل&فون&نمبر&درج&کریں۔
CONFIRM&	確認&	确认	ยืนยัน&	CONFIRMAR&	CONFIRMAR&	CONFIRMER&	CONFIRMER&	BESTÄTIGEN&	ПОДТВЕРДИТЬ&	POTVRDIŤ&	CONFERMA&	تأكيد&	CONFIRMAR&	ONAYLA&	XÁC&NHẬN&	KONFIRMASI&	SAHKAN&	पुष्टि&करें&	BEKRÆFT&	POTVRDIT&	POTWIERDŹ&	MEGERŐSÍTÉS&	VAHVISTA&	BEVESTIGEN&	BEKRÄFTA&	POTVRDA&	CONFIRMAȚI&	POTRDI&	ΕΠΙΒΕΒΑΙΩΣΗ&	אשר&	ПОТВЪРЖДАВАНЕ&	ПІДТВЕРДИТИ&	CONFIRMAR&	CONFIRMAR&	تأیید&	POTVRDI&	확인&	確認&	BEKREFT&	ПОТВРДИ	CONFIRMAR&	BERRETSI&	KONFIRMO&	নিশ্চিত&	បញ្ជាក់&	အတည္ျပဳရန္&	APSTIPRINĀT&	PATVIRTINTI&	KINNITA&	ຢືນຢັນ&	تصدیق&کریں&
CANCEL	取消	取消	ยกเลิก	CANCELAR	CANCELAR	ANNULER	ANNULER	ABBRECHEN	ОТМЕНА	ZRUŠIŤ	ANNULLA	إلغاء	CANCELAR	İPTAL	HỦY	BATAL	BATALKAN	रद्द&करें	AFBRYD	ZRUŠIT	ANULUJ	MÉGSE	PERUUTA	ANNULEREN	AVBRYT	ODUSTANI	ANULAȚI	PREKLIČI	ΑΚΥΡΩΣΗ	ביטול	ОТКАЗ	СКАСУВАТИ	CANCELAR	CANCEL·LAR	لغو	OTKAŽI	취소	キャンセル	AVBRYT	ОТКАЖИ	CANCELAR	UTZI	ANULLO	বাতিল	បោះបង់	ပယ္ဖ်က္ရန္	ATCELT	ATŠAUKTI	LOOBU	ຍົກ​ເລີກ​	منسوخ&کریں
"Exchange&successfully&
We&will&top&up&the&mible&phone&charge&asap.&"	成功交換&	兑换成功&我们将尽快为您的手机充值。	การแลกเปลี่ยนเสร็จสมบูรณ์&เราจะเติมเงินค่าโทรศัพท์ให้คุณภายในทันที&	"El&intercambio&se&ha&completado&correctamente.&
Recargaremos&el&teléfono&móvil&lo&antes&posible.&"	"El&intercambio&se&ha&completado&correctamente.&
Recargaremos&el&teléfono&móvil&lo&antes&posible.&"	"Échange&effectué&
Nous&créditerons&votre&solde&dès&que&possible.&"	"Échange&réussi&
Nous&remplirons&le&compte&du&téléphone&mobile&le&plus&rapidement&possible.&"	"Tauschen&erfolgt
Wir&laden&das&Guthaben&des&Mobiltelefons&schnellstmöglich&auf.&"	"Успешный&обмен&
Мы&пополним&счёт&мобильного&телефона&как&можно&скорее.&"	"Výmena&úspešná&
Čoskoro&navýšime&vyúčtovanie&za&mobilný&telefón.&"	"Scambio&avvenuto&correttamente&
Ricaricheremo&il&telefono&il&prima&possibile.&"	"تم&التبادل&بنجاح
سنقوم&بزيادة&رسوم&الهاتف&المحمول&في&أقرب&وقت&ممكن.&"	"Troca&efetuada
Iremos&carregar&o&telemóvel&o&mais&breve&possível.&"	"Başarıyla&takas&yapıldı
Cep&telefonu&ücretini&mümkün&olduğunca&çabuk&yükleyeceğiz.&"	"Trao&đổi&thành&công&
Chúng&tôi&sẽ&nạp&phí&điện&thoại&di&động&sớm&nhất&có&thể.&"	"Berhasil&ditukar
Kami&akan&segera&mengisi&pulsa&ponsel.&"	"Pertukaran&berjaya&
Kami&akan&menambah&caj&telefon&bimbit&dengan&segera.&"	"विनिमय&सफल
हम&मोबाइल&फोन&चार्ज&को&यथाशीघ्र&टॉप&अप&करेंगे.&"	Vekslingen&succesfuldVil&vil&indsætte&beløbet&på&din&mobiltelefonregning&snarest&muligt.&	"Výměna&byla&úspěšná&
Váš&mobilní&telefon&bude&co&nejdřív&dobit.&"	"Wymiana&powiodła&się&
Niezwłocznie&doładujemy&Twoje&konto.&"	"Váltás&sikerült&
A&lehető&leghamarabb&feltöltjük&a&mobiltelefonja&egyenlegét.&"	"Vaihto&onnistui&
Täydennämme&matkapuhelinmaksun&mahdollisimman&nopeasti.&"	"Omwisselen&voltooid.&
We&vullen&het&mobiele-telefoontegoed&zo&snel&mogelijk&aan.&"	Bytet&lyckades.&Vi&kommer&att&ladda&din&mobil&omgående.&	"Razmjena&uspjela
Nadopunit&ćemo&vaš&račun&u&što&kraćem&mogućem&roku.&"	"Schimbare&reușită
Vom&încărca&imediat&contul&dvs. &"	Izmenjava&uspešna.&Kredit&mobilnega&telefona&bomo&napolnili&čim&prej.&	"Η&ανταλλαγή&ήταν&επιτυχής&
Η&χρέωση&τηλεφώνου&θα&ανανεωθεί&άμεσα.&"	"ההמרה&הצליחה
חשבון&הטלפון&שלך&יזוכה&באופן&מיידי&"	"Успешна&обмяна&
Ще&заредим&таксата&за&мобилния&телефон&възможно&най-бързо.&"	"Обмін&здійснено&успішно&
Мобільний&рахунку&буде&поповнено&найближчим&часом.&"	"Troca&bem-sucedida&
Completaremos&a&recarga&do&celular&assim&que&possível.&"	"El&bescanvi&s'ha&realitzat&correctament.&
Carregarem&el&saldo&del&mòbil&al&més&aviat&possible.&"	"مبادله&شد&
در&اسرع&وقت&تلفن&همراه&را&شارژ&می&کنیم.&"	"Razmena&je&uspela
Dopunićemo&račun&mobilnog&telefona&što&je&pre&moguće.&"	"교환이&성공적으로&이루어졌습니다.
휴대폰을&최대한&빨리&충전시키겠습니다.&"	"交換が完了しました
携帯電話のチャージをできるだけ早くトップアップ(追加)いたします。&"	"Veksling&utført
Vi&vil&fylle&på&mobilen&din&nå.&"	Успешна&размена.&Ќе&го&надополниме&мобилниот&телефон&наскоро.	"Troco&realizado.
Recargaremos&o&teléfono&móbil&o&antes&posible.&"	"Egin&da&trukea&
Ahal&bezain&laster&gehituko&dugu&saldoa&telefono&mugikorrean.&"	Shkëmbimin&me&suksesNe&do&të&bëjmë&me&kualitet&më&të&lartë&mbushjen&e&telefonin&celularin&tuaj&&sa&më&shpejtë&që&është&e&mundur.&	"সফলভাবে&এক্সচেঞ্জ
আমরা&যত&দ্রুত&সম্ভব&মোবাইল&ফনে&টপ&আপ&করে&দেব।&"	"ផ្លាស់ប្តូរដោយជោគជ័យ&
យើងនឹងបញ្ចូលលុយទូរស័ព្ទចល័តឱ្យឆាប់តាមតែអាចធ្វើបាន។&"	"ေအာင္ျမင္စြာ&ဖလွယ္ၿပီးပါၿပီ
မုိဘုိင္းဖုန္းအတြက္&ျမန္ႏုိင္သမွ်&အျမန္ဆံုး&ေငြျဖည့္သြင္းေပးပါမည္။&"	"Maiņa&izdevās&
Mēs&papildināsim&mobilā&tālruņa&līdzekļus&pēc&iespējas&drīz.&"	"Pakeista&sėkmingai
Papildysime&mobilaus&telefono&sąskaitą&netrukus.&"	"Vahetus&õnnestus.
Laadime&mobiiltelefonile&nii&kiiresti&kui&võimalik&
&"	"ແລກ​ປ່ຽນ&ສຳ​ເລັດ&
ພວກ​ເຮົາ​ຈະ​ຕື່ມ​ຄ່າ​ໂທ​ລະ​ສັບ​​ມື​ຖື​ໄວໆ​ນີ້.&"	"ایکسچینج&کامیاب
ہم&موبائل&فون&چارج&جلد&از&جلد&ٹاپ&اپ&کرینگے۔&"
Exchange&is&failed，please&try&again.	交換失敗，請再次嘗試。	兑换失败，请重试	การแลกเปลี่ยนล้มเหลว&โปรดลองอีกครั้ง	Se&ha&producido&un&error&en&el&intercambio.&Inténtelo&de&nuevo.	Se&ha&producido&un&error&en&el&intercambio.&Inténtelo&de&nuevo.	L’échange&a&échoué.&Veuillez&réessayer.	Échange&non&réussi.&Veuillez&essayer&de&nouveau.	Tausch&fehlgeschlagen.&Versuchen&Sie&es&erneut.	Сбой&при&обмене,&повторите&попытку.	Výmena&zlyhala.&Skúste&to&neskôr.	Scambio&non&riuscito,&riprovare.	فشل&التبادل،&يرجى&المحاولة&مرة&أخرى.	A&troca&falhou,&tente&novamente.	Takas&başarısız&oldu,&lütfen&tekrar&deneyin.	Trao&đổi&thất&bại,&vui&lòng&thử&lại.	Gagal&menukar,&cobalah&lagi.	Pertukaran&gagal,&sila&cuba&lagi.	विनिमय&विफल&हो&गया,&कृपया&पुन:प्रयास&करें.	Vekslingen&fejlede,&prøv&venligst&igen.	Výměna&se&nezdařila.	Wymiana&nie&powiodła&się,&spróbuj&ponownie.	A&váltás&sikertelen,&próbálja&meg&újra.	Vaihto&epäonnistui.&Yritä&uudelleen.	Omwisselen&is&mislukt.&Probeer&het&opnieuw.	Bytet&misslyckades,&var&god&försök&igen.	Razmjena&nije&uspjela,&molimo&pokušajte&ponovno.	Schimbare&nereușită.&Încercați&din&nou.	Izmenjava&ni&bila&uspešna,&poskusite&znova.	Η&ανταλλαγή&απέτυχε.&Δοκιμάστε&ξανά.	ההמרה&לא&הצליחה,&אנא&נסה&שוב.	Неуспешна&обмяна,&моля,&опитайте&отново.	Збій&обміну,&спробуйте&ще&раз.	Troca&mal&sucedida,&tente&novamente.	No&s'ha&pogut&realitzar&el&bescanvi.&Torneu&a&provar-ho.	مبادله&نشد،&لطفاً&دوباره&امتحان&کنيد.	Razmena&nije&uspela,&pokušajte&ponovo.	교환&실패,&다시&시도하십시오.	交換が失敗しました。再試行してください。	Veksling&mislyktes.&Prøv&på&nytt.	Неуспешна&размена,&обидете&се&повторно	Non&se&realizou&o&troco.&Ténteo&de&novo.	Ezin&izan&da&egin&trukea.&Saiatu&berriro.	Shkëmbim&i&dështuar,&ju&lutem&provoni&përsëri.	এক্সচেঞ্জ&ব্যর্থ&হয়েছে,&অনুগ্রহ&করে&আবার&চেষ্টা&করুন।	ផ្លាស់ប្តូរបានបរាជ័យ&សូមព្យាយាមម្តងទៀត។	ဖလွယ္ျခင္း&မေအာင္ျမင္ပါ၊&ထပ္ႀကိဳးစားပါ။	Maiņa&neizdevās,&lūdzu,&mēģiniet&vēlreiz.	Pakeisti&nepavyko,&pabandykite&dar&kartą.	Vahetus&ebaõnnestus,&proovi&uuesti.	ການແລກ​ປ່ຽນບໍ່ສໍາເລັດ,&ກະລຸນາລອງໃໝ່ອີກ.	ایکسچینج&ناکام&ہو&گیا&ہے،&بعد&میں&دوبارہ&کوشش&کریں۔
Exchanged	已交換	已兑换	แลกเปลี่ยนแล้ว	Intercambio&realizado	Intercambio&realizado	Échangé	Échangé	Getauscht	Обменено	Vymenené	Scambiato	تم&التبادل	Trocado	Takas&yapıldı	Đã&trao&đổi	Ditukar	Ditukar	विनिमय&हो&गया	Vekslet	Vyměněno	Dokonano&wymiany	Váltás&megtörtént	Vaihdettu	Omgewisseld	Bytt	Razmijenjeno	Schimbare&realizată	Izmenjano	Η&ανταλλαγή&ολοκληρώθηκε	בוצעה&המרה	Обменено	Здійснено&обмін	Trocado	Bescanvi&realitzat	مبادله&شد	Razmenjeno	교환됨	交換済み	Vekslet	Разменето	Trocos	Egin&da&trukea	E&shkëmbyer	এক্সচেঞ্জ&করা&হয়েছে	បានផ្លាស់ប្តូរ	ဖလွယ္ၿပီးပါၿပီ	Notikusi&maiņa	Pakeista	Vahetatud	​ແລກ​ປ່ຽນແລ້ວ	ایکسچینج&شدہ
EXCHANGE	交換	兑换	แลกเปลี่ยน	INTERCAMBIO	INTERCAMBIO	ÉCHANGER	ÉCHANGE	TAUSCHEN	ОБМЕН	VYMENIŤ	SCAMBIA	التبادل	TROCAR	TAKAS	TRAO&ĐỔI	TUKAR	PERTUKARAN	विनिमय	VEKSLE	VYMĚNIT	WYMIANA	VÁLTÁS	VAIHTO	OMWISSELEN	BYT	RAZMJENA	SCHIMBAȚI	IZMENJAVA	ΑΝΤΑΛΛΑΓΗ	המרה	ОБМЯНА	ОБМІН	TROCA	BESCANVI	مبادله	RAZMENA	교환	交換	VEKSLE	РАЗМЕНИ	TROCAR	TRUKATU	SHKËMBIM	এক্সচেঞ্জ	ផ្លាស់ប្តូរ	ဖလွယ္ရန္	MAIŅA	KEISTI	VAHETA	ແລກ​ປ່ຽນ	ایکسچینج
